NO ./textures/cherry_planks.xpm
SO ./textures/cherry_log.xpm
WE ./textures/crimson_planks.xpm
EA ./textures/dropper_front.xpm
F 121,81,66
C 164,211,247

11111111
101000E1
10100001
10100001
10000001
10000101
10000001
10100001
10100001
10000001
10000101
10000001
10000001
10000101
10000001
11111111
